1111111
100DEC1
1P0C001
1111111
