11111111111111111111
10000C1111E000100001
100000111100001000C1
10010001100010011001
11000000000000011001
10P0011100C0000000C1
11111111111111111111