1111111
1000EC1
1P0C001
1111101
