1111111
10000C1
1P0C001
1111111
