1111111
100PEC1
1P0C001
1111111
