1111111
1000E01
1P00001
1111111
