111111111111
1P111C0001E1
100000000111
111111111111
