1111111
1000EC1
1P0C0011
1111111
