111111111
1000EC111
1P0C0C111
111111111